**********
*XXX*XXXXX
***X*****X
*X*XXX*XXX
*X***X***X
*XXXXX*XXX
*****X***X
*X*X*XXX*X
*X*X***X**
*XXXXX*XX*

