**********
*XXX*X*XXX
***X*X***X
*XXXXXXXXX
*********X
*XXXXXXXXX
*********X
*X*X*X*X*X
*X*X*X*X**
*X*XXX*XX*